#######################
S #   #   #   #   #   #
# # # # # # # # # # # #
# # # # # # # # # # # #
# # # # # # # # # # # #
# # # # # # # # # # # #
# # # # # # # # # # # #
# # # # # # # # # # # #
# # # # # # # # # # # #
# # # # # # # # # # # #
# # # # # # # # # # # #
#   #   #   #   #   # E
#######################