###E###
S #   #
# ### #
#  ## #
# #   #
#   # #
#######